缪	miao 
强	qiang 
贾	jia 
查	zha 
沈	shen 
羊	yang 
暴	bao 
景	jing 
广	guang 
阚	kan 
殷	yin 
瞿	qu 
柏	bai 
卜	bu 
翟	zhai 
郦	li 
蔚	yu 
陈	chen 
汤	tang 
俞	yu 
叶	ye 
莫	mo 
臧	zang 
石	shi 
能	nai 
薄	bo 
从	cong 
曾	zeng 
隗	kui 
那	na 
仇	qiu 
乜	nie 
万	wan 
蔡	cai 
单	shan 
都	du 
彭	peng 
宿	su 
解	xie 
红	hong 
竺	zhu 
褚	chu 
贲	fei 
乐	le 
盛	sheng 
车	che 
和	he 
朱	zhu 
谷	gu 
孙	sun 
糜	mi 
仰	yang 
盖	ge 
宓	fu 
冯	feng 
訾	zi 
陆	lu 
陶	tao 
艾	ai 
丁	ding 
莘	shen 
许	xu 
於	yu 
